g . . o .
p o . p o
. . . . .
o p . o .
. . p . .
. . . . .
. . o o o
. . o s .
. . . . o