s . . . . . . .
p o . p o . . .
. . o o . o . .
o . . o . o . .
. . . . o . . .
. . . g . . o .