s . . p . .
p o . p o .
. . . . . .
o p . o . o
. . p . g p